15
XXXXXXXXXXXXXXX
XOOOOOOOOOOXOOX
XOXXXXXXXXOXOXX
XOXEOOOOXXOXOXX
XOXXXXXOXXOXOXX
XOOOOOOOXOOXOXX
XXXXXXXXXOXXOXX
XOOOOOOOOOOSOOX
XOXXXXXXXXOXXOX
XOXXXXXXXXOXOOX
XOOOOOOOOOOXOXX
XOXXXXXXXOXXOOX
XOXXXXXXXOXXXOX
XOOOOOOOOOOOOOX
XXXXXXXXXXXXXXX