6
XXXXXX
XSOOOX
XOXOXX
XOXXXX
XOOEXX
XXXXXX