9
OOOOOOOOX
OXOXOXXOX
OXOXOXXOX
OXXXXXXOX
OXOXEXXOX
OXOXXXXOX
OXOOOOOOX
OXXXXXXXX
SOOOOOOOO