11
XXXXXXSXXXX
XOXOOOOXOOX
XOOOXXOOOXX
XOXOOOXOXOX
XOXXXOXOOOX
XOOOXOXOXOX
XXXXXOXOXXX
XOOOOXXOOOX
XXOXOXXXXOX
EOOXOOOOOOX
XXXXXXXXXXX