12
XOSXXXXXXXXX
XOOOOOOOOOXX
XXXOXXXXXOXX
XXXXOOOOOOXX
XXXXOXXOXXXX
XXXXOOOXXXXX
XXXXXXOXXXXX
XXXXXOOOOOXX
XXXXXOXOXOXX
XXXXOOXOOOXX
XXXXXXXXXOXX
XXXXXXXXXOOE